1,2	3,4,
1,3	2,4,
1,4	2,3,
2,3	1,4,5,
2,4	1,3,5,
2,5	3,4,
3,4	1,2,5,
3,5	2,4,
4,5	2,3,
